###############
###############
###############
###############
##222#####222##
###############
###############
###############
######222######
###############
###############
###############
#222222222#####
###############
###############
###############
############2##
###############
###############
###############
###22222222####
###############
###############
###############
#22#########2##
###############
###############
###############
222222222222222
